____wwwwwwww
____w______w
____w_s____w
____w______w
wwwww___!__w
w__________w
w_F___f____w
w__________w
wwwwwwwwwwww
____w______w
_B__w_W____w
_s__w_s__b_w
_U__w_S____w
____w______w
____wwwwwwww