WsSll____________________________
_________________________________
_________________________________
_________________________________
_________________________________
_________________________________
___________BsU_____Fs!___________
_________________________________
___________wwwwwwwwwww___________
________________r________________
____________b___r___f____________
________________r________________
___________wwwwwwwwwww___________
_________________________________
___________WsS_____RsP___________
________________________________l
_______________________________ll
______________________________lll