BWw___________________
ssw____wwwwwwww_______
USw____w______w_______
www____w_b__r_w_______
______Tw______w_______
______sw____r_w_______
______Nw______w_______
____wwwwtttwwwwwww____
____w______w_____w____
____w______w_RsP_w____
____w______w_____w____
____wttt_w_______w____
____wttt___w_Fs!_w____
____wftt___w_____w____
____wwwwwwwwwwwwww____
______________________