Fs!_____________________
BsU_____________________
________________________
_____________kkkkkkkkk__
_____________k_______k__
__RsP________k_K_____k__
_____________k_s_____k__
_____k_k_____k_X_____k__
_____krk_____k_______k__
___kkkrkkk___k____f__k__
___k__r__k___k_______k__
___k_____k___kkkkkkkkk__
___k__b__k______________
___k_____k______________