______________________
_________wwwwwwww_____
_________w______w_____
_________w_s____w_____
_________w______w_____
_____wwwww___!__w_____
_____w__________w_____
_____w_F___f____w_____
_____w__________w_____
_____wwwwwwwwwwww_____
_________w______w_____
______B__w_W____w_____
______s__w_s__b_w_____
______U__w_S____w_____
_________w______w_____
_________wwwwwwww_____
______________________
______________________