WsSll_w_____w___w________________
llll__w_______b_w________________
ll____w_____w___w________________
l_____w_BsU_wwwww________________
______ww___ww____________________
______w_____r____________________
______wwwwwww____________________
______wRw________________________
_______s___wwwwwwwwwww___________
_______P________r________________
____________b___r___f____________
________________r________________
_______w___wwwwwwwwwww___________
_______wwwww_____________________
_______w___WsS_____RsP___________
_______w________________________l
_______________________________ll
______________________________lll