______________________
_________ffffffff_____
_________f______f_____
_________f_s____f_____
_________f______f_____
_____fffff___!__f_____
_____f__________f_____
_____f_B___f____f_____
_____f__________f_____
_____ffffffffffff_____
_________f______f_____
______W__f_F____f_____
______s__f_s__w_f_____
______U__f_S____f_____
_________f______f_____
_________ffffffff_____
______________________
______________________