RsP_______________Fs!_________TsN
______________________r__________
________G______________________gg
_______________________________gf
t___________b___r______________gg
tt_______________________________
ttttt_______________BsU__________
GsXttt______r__________E_________
TsXtttt__________________________