BsU_____Fs!
___________
wwwwwwwwwww
_____r_____
_b___r___f_
_____r_____
wwwwwwwwwww
___________
WsS_____RsP